# ########
#/    !   
# # @    #
# # @ #@##
####     #
#    ##@ #
## #  @!@#
#!  !@  !#
#  ## @ D#
##########