###############################################
#                                             #
#   /                                         #
#                 ###############             #
#                 #             #             #
#  !              @!   ######   #             #
#                 #    #    @   #             #
#                 #    #! D #   #             #
#                 #    #@####   #             #
#                 #             #             #
#                 #######@#######             #
#                                             #
#                        !                    #
###############################################