#	#	#	#	#	#	#	#	#	#
#	\	#	@	@		!			#
#		#		@					#
#		#		@		#	@	#	#
#		@	@				@		#
#	#	#	#						#
#					#	#	#		#
#	#		#			@		@	#
#				@		@	@		#
#	!			!	@			!	#
#			#	#		@			#
#								D	#
#	#	#	#	#	#	#	#	#	#
