############################
#                          ##
#  /                        ####
#                           @  ########
#                           #     @   #
######            !         # !   @   #
     ######                 @@    @!D #
           ############################