############################
#                          ##
#  /                        ####
#                           @  ########
#                           #     @   #
######              !       #     @   #
     ######                 @@  ! @!D #
           ############################