######################################
#                                    #
# /          !               !       #
#        ########@##############     #
#        #                   ! #     #
#        #    ##############   #     #
#        #    # !    @     #   #     #
#        #    #      #     #   #     #
#        #    #####  #  !  #   #     #
#        #    #!  D  #     #   #     #
#        #    #  !#! #     #   #     #
#        #    ###@####@#####   #     #
#        #                     #     #
#        ##########  ###########     #
#        @      ! @  @ !@            #
######################################