###############################
#                             #
#   /                         #
#                             #
#                            D#
#                       #######
#                       #
#                       #
#                       #
#                       #
#                       #
#                   !   #
#########################
          
          