##########
#/ @@ !  #
# # @    #
# # @ #@##
####     #
#    ### #
## #  @ @#
#!  !@  !#
#  ## @ D#
##########