# ########
#/ D  !   
#        #
#     #@##
#  #     #
#      @ #
## #    @#
#!      !#
#  #     #
##########